#Список Кири
BRG = "countries/Burgundia.txt"
MOR = "countries/Moravia.txt"
KRA = "countries/Krakow.txt"
ALA = "countries/Aland.txt"
SCA = "countries/Scania.txt"
SAL = "countries/Salzburg.txt"
KNT = "countries/Karnten.txt"
STE = "countries/Steiermark.txt"
FRR = "countries/Forarlberg.txt"
KRF = "countries/Korfu.txt"
SMK = "countries/Smolensk.txt"
BGL = "countries/Burgenland.txt"
NKH = "countries/Nakhchivan.txt"
DUB = "countries/Dubrovnik.txt"
BDN = "countries/Baden.txt"
ESN = "countries/Essen.txt"
KLN = "countries/Koln.txt"
BRB = "countries/Baranya Baja.txt"
LAP = "countries/Laplandia.txt"
MEM = "countries/Memel.txt"
BRU = "countries/Braunschweig.txt"
MGB = "countries/Magdeburg.txt"
KHA = "countries/Khakassia.txt"
BRD = "countries/Brandenburg.txt"
POM = "countries/Pomern.txt"
MKB = "countries/Mecklenburg.txt"
SLE = "countries/Schleswig.txt"
#Пашалыки
TKN = "countries/Turkestan.txt"
GMN = "countries/Great_Mongolia.txt"
